111111111
1PCC00E01
1CCC00001
1CCC00E01
1CCC01001
1C1C01E01
1CCC00E01
1CCC00E01
111111111