111111111
1PCC00E01
1CCC00E01
1CCC00E01
1CCC01E01
1C1C01E01
1CCC00E01
1CCC00E01
111111111