111111111
1CCC0P001
1CCCCC001
10000E001
111111111