1111111111111111111111111111
10000M0000000000000000000001
1E0C000000000000000000000001
10000000000M0000000000000001
1000000000000000000000000001
100000000M000000000000000001
1000000000000P00000000000001
1000000M00000000000000000001
1000000000000000000000000001
10000M0000000000000000000001
1000000000000000000000000001
1000M000000000000M0000000001
1000000000000000000000000001
1000000000000000000000000001
1111111111111111111111111111