11111111111
1PCCCCCCCC1
10E00000001
11111111111