1111111111111111111111111111111
1CCCC1MMM000C1MMC1CC0001M0000M1
11MMCC10M0CCC1M10CCC10MMCC1M001
11MMCC100CCC1MM0CM1M01100E00001
11MMCC001M0CC10M0000011M1MC1001
10000E00CC10CCCC101000000MC0001
11MMCC1M10CC10MM0C1000MC0C00001
1000P1MMCC1M000001CC10C110M00C1
11MMCC1MM0CC1M00CE1M0001MCMMMM1
10000M1MMCC1M0000000C00CC10E001
1111111111111111111111111111111