1111111111111111111111111111
10M0000000000000000000000001
1EC0000000000000000000000001
10P00000000M0000000000000111
1000000000000000000000000001
100000000M000000000000000001
1000000000000000000000000001
1000000M00000000000000000001
1000000000000000000000000001
10000M0000000000000000000001
1000000000000000000000000001
1000M000000000000M0000000001
1000000000000000000000000001
1000000000000000000000000001
1111111111111111111111111111