111111111111111
1C01000C000C111
100001011011CC1
1P001111E000001
111111111111111