11111111111
1PCC1CCC1C1
10E00010001
11111111111