11111111111111111111
1MC0CMC0C0C0C0C0MEM1
11M1C1EM1MCMC1C0MMC1
10CMC1MMC0C0C110C0C1
1MC0C1C0CM1MCM1111C1
1MCMC0C1CM11C0C1C0C1
10C1C1CMC0CMCMC110M1
1PE00C10C10C1MC1MC11
11111111111111111111